111111111111
101110100001
101110111101
101110111011
10000N110111
111110101111
111110100001
111111111111
