NO ./textures/wall.png
SO ./textures/wall.png
WE ./textures/wall.png
EA ./textures/wall.png

F 0,180,0
C 0,191,255

111111111111111111
1                1
1 11111111111111 1
1 10000000000001 1
1 10000010000001 1
1 10000000000001 1
1 100000N0000001 1
1 10000000000001 1
1 10000000000001 1
1 10000000000001 1
1 11111111111111 1
1                1
111111111111111111