NO ./textures/wall.png
SO ./textures/wall.png
WE ./textures/wall.png
EA ./textures/wall.png

F 0,180,0
C 0,191,255

111111111111111111111
1000000000000000000011
110000000000000000000111111
 1100000000010000000000000011
  1100000001110000000000000011
   110000000100000000000000001
   110000000000111110001111111
    111000001111100000000011
     1100001000000000000011
    111100000000000110001111
 111110000000000000000000001
 1100000000N00000000000000111
110000000000000000000001111
100000000000000001111111
1111111111111111111
