11111111111111
10000000000001
10000000000001
10000000000001
11111101111111
11111121111111
11111101111111
10000000000001
100000N0000001
11111111111111
