NO          ./textures/north.png       


SO   ./textures/sud.png       
   
  
F       0,180,0
C          0,191,255

WE         ./textures/ouest.png    


EA          ./textures/est.png  
 111111111111
10000000000001
10000000000001
10000000000001
 111100011111
     121
 111100011111
10000000000001
100000N0000001
 111111111111