11111111111111
10000000000001
10010000000001
10010000000001
10011110111111
10010000000001
10010000000001
10N10000000001
11111111111111
